*............./....*
*#******************
*#........./.......*
******************#*
*............/....#*
**#*****************
*.#....../.........*
******************#*
*.@...............#*
********************