....................
*#******************
*#.................*
******************#*
*.................#*
**#*****************
*.#................*
******************#*
*.@...............#*
********************