*.........+.../....*
*#******************
*#........./......#*
******************#*
*.#........../....#*
**#*****************
*.#....../........#*
******************#*
*.@...............#*
********************