*..%........../....*
*#****************#*
*#/......#......./#*
*********#**********
*#.......#.../....#*
*#****************#*
*#/......#......./#*
*********#**********
*.@......#.........*
********************