*..%........../....*
*#****************#*
*#/............../#*
*********#**********
*........#.../.....*
*#****************#*
*#/............../#*
*********#**********
*.@......#.........*
********************