*............./....*
*#****************#*
*#/............../#*
*********#**********
*........#.../.....*
*#****************#*
*#/............../#*
*********#**********
*.@......#.........*
********************