*..%........../....*
*#******************
*#/....../........#*
******************#*
*./.....#..../....#*
********#***********
*./...#*#../......#*
******#***********#*
*.@...#....../....#*
********************